{
  "name": "Pachi RGB Rev2",
  "vendorProductId": 1480937555,
  "macros": ["", "", "", "", "", "", "", "", "", "", "", "", "", "", "", ""],
  "layers": [
    [
      "KC_ESC",
      "KC_F1",
      "KC_F3",
      "KC_F5",
      "KC_F7",
      "KC_F9",
      "KC_F11",
      "KC_PSCR",
      "KC_PAUS",
      "KC_NO",
      "KC_F2",
      "KC_F4",
      "KC_F6",
      "KC_F8",
      "KC_F10",
      "KC_F12",
      "KC_SLCK",
      "KC_NO",
      "KC_GRV",
      "KC_2",
      "KC_4",
      "KC_6",
      "KC_8",
      "KC_0",
      "KC_EQL",
      "KC_INS",
      "KC_PGUP",
      "KC_1",
      "KC_3",
      "KC_5",
      "KC_7",
      "KC_9",
      "KC_MINS",
      "KC_BSPC",
      "KC_HOME",
      "KC_NO",
      "KC_TAB",
      "KC_W",
      "KC_R",
      "KC_Y",
      "KC_I",
      "KC_P",
      "KC_RBRC",
      "KC_DEL",
      "KC_PGDN",
      "KC_Q",
      "KC_E",
      "KC_T",
      "KC_U",
      "KC_O",
      "KC_LBRC",
      "KC_BSLS",
      "KC_END",
      "KC_NO",
      "KC_LCTL",
      "KC_S",
      "KC_F",
      "KC_H",
      "KC_K",
      "KC_SCLN",
      "KC_NO",
      "KC_NO",
      "KC_NO",
      "KC_A",
      "KC_D",
      "KC_G",
      "KC_J",
      "KC_L",
      "KC_QUOT",
      "KC_ENT",
      "KC_NO",
      "KC_NO",
      "KC_LSFT",
      "KC_X",
      "KC_V",
      "KC_N",
      "KC_COMM",
      "KC_SLSH",
      "KC_RSFT",
      "KC_NO",
      "KC_NO",
      "KC_Z",
      "KC_C",
      "KC_B",
      "KC_M",
      "KC_DOT",
      "KC_NO",
      "KC_NO",
      "KC_UP",
      "KC_NO",
      "KC_LCTL",
      "KC_LGUI",
      "KC_NO",
      "KC_NO",
      "KC_NO",
      "KC_RGUI",
      "KC_RALT",
      "KC_LEFT",
      "KC_RGHT",
      "KC_LALT",
      "KC_NO",
      "KC_SPC",
      "KC_NO",
      "KC_NO",
      "KC_NO",
      "MO(1)",
      "KC_DOWN",
      "KC_NO"
    ],
    [
      "KC_TRNS",
      "KC_TRNS",
      "KC_TRNS",
      "KC_TRNS",
      "KC_TRNS",
      "KC_TRNS",
      "KC_TRNS",
      "KC_TRNS",
      "KC_TRNS",
      "KC_NO",
      "KC_TRNS",
      "KC_TRNS",
      "KC_TRNS",
      "KC_TRNS",
      "KC_TRNS",
      "KC_TRNS",
      "KC_TRNS",
      "KC_NO",
      "KC_TRNS",
      "KC_TRNS",
      "KC_TRNS",
      "KC_TRNS",
      "KC_TRNS",
      "KC_TRNS",
      "KC_TRNS",
      "KC_TRNS",
      "KC_TRNS",
      "KC_TRNS",
      "KC_TRNS",
      "KC_TRNS",
      "KC_TRNS",
      "KC_TRNS",
      "KC_TRNS",
      "RESET",
      "KC_TRNS",
      "KC_NO",
      "KC_CAPS",
      "RGB_RMOD",
      "RGB_HUD",
      "RGB_SAD",
      "RGB_VAD",
      "KC_TRNS",
      "KC_TRNS",
      "KC_TRNS",
      "KC_TRNS",
      "RGB_TOG",
      "RGB_MOD",
      "RGB_HUI",
      "RGB_SAI",
      "RGB_VAI",
      "KC_TRNS",
      "KC_TRNS",
      "KC_TRNS",
      "KC_NO",
      "KC_TRNS",
      "KC_TRNS",
      "KC_TRNS",
      "KC_TRNS",
      "KC_TRNS",
      "KC_TRNS",
      "KC_NO",
      "KC_NO",
      "KC_NO",
      "KC_TRNS",
      "KC_TRNS",
      "KC_TRNS",
      "KC_TRNS",
      "KC_TRNS",
      "KC_TRNS",
      "KC_TRNS",
      "KC_NO",
      "KC_NO",
      "KC_TRNS",
      "KC_TRNS",
      "KC_TRNS",
      "KC_TRNS",
      "KC_TRNS",
      "KC_TRNS",
      "KC_TRNS",
      "KC_NO",
      "KC_NO",
      "KC_TRNS",
      "KC_TRNS",
      "KC_TRNS",
      "KC_TRNS",
      "KC_TRNS",
      "KC_NO",
      "KC_NO",
      "KC_TRNS",
      "KC_NO",
      "KC_TRNS",
      "KC_TRNS",
      "KC_NO",
      "KC_NO",
      "KC_NO",
      "KC_TRNS",
      "KC_TRNS",
      "KC_TRNS",
      "KC_TRNS",
      "KC_TRNS",
      "KC_NO",
      "KC_TRNS",
      "KC_NO",
      "KC_NO",
      "KC_NO",
      "KC_TRNS",
      "KC_TRNS",
      "KC_NO"
    ],
    [
      "KC_TRNS",
      "KC_TRNS",
      "KC_TRNS",
      "KC_TRNS",
      "KC_TRNS",
      "KC_TRNS",
      "KC_TRNS",
      "KC_TRNS",
      "KC_TRNS",
      "KC_NO",
      "KC_TRNS",
      "KC_TRNS",
      "KC_TRNS",
      "KC_TRNS",
      "KC_TRNS",
      "KC_TRNS",
      "KC_TRNS",
      "KC_NO",
      "KC_TRNS",
      "KC_TRNS",
      "KC_TRNS",
      "KC_TRNS",
      "KC_TRNS",
      "KC_TRNS",
      "KC_TRNS",
      "KC_TRNS",
      "KC_TRNS",
      "KC_TRNS",
      "KC_TRNS",
      "KC_TRNS",
      "KC_TRNS",
      "KC_TRNS",
      "KC_TRNS",
      "KC_TRNS",
      "KC_TRNS",
      "KC_NO",
      "KC_TRNS",
      "KC_TRNS",
      "KC_TRNS",
      "KC_TRNS",
      "KC_TRNS",
      "KC_TRNS",
      "KC_TRNS",
      "KC_TRNS",
      "KC_TRNS",
      "KC_TRNS",
      "KC_TRNS",
      "KC_TRNS",
      "KC_TRNS",
      "KC_TRNS",
      "KC_TRNS",
      "KC_TRNS",
      "KC_TRNS",
      "KC_NO",
      "KC_TRNS",
      "KC_TRNS",
      "KC_TRNS",
      "KC_TRNS",
      "KC_TRNS",
      "KC_TRNS",
      "KC_NO",
      "KC_NO",
      "KC_NO",
      "KC_TRNS",
      "KC_TRNS",
      "KC_TRNS",
      "KC_TRNS",
      "KC_TRNS",
      "KC_TRNS",
      "KC_TRNS",
      "KC_NO",
      "KC_NO",
      "KC_TRNS",
      "KC_TRNS",
      "KC_TRNS",
      "KC_TRNS",
      "KC_TRNS",
      "KC_TRNS",
      "KC_TRNS",
      "KC_NO",
      "KC_NO",
      "KC_TRNS",
      "KC_TRNS",
      "KC_TRNS",
      "KC_TRNS",
      "KC_TRNS",
      "KC_NO",
      "KC_NO",
      "KC_TRNS",
      "KC_NO",
      "KC_TRNS",
      "KC_TRNS",
      "KC_NO",
      "KC_NO",
      "KC_NO",
      "KC_TRNS",
      "KC_TRNS",
      "KC_TRNS",
      "KC_TRNS",
      "KC_TRNS",
      "KC_NO",
      "KC_TRNS",
      "KC_NO",
      "KC_NO",
      "KC_NO",
      "KC_TRNS",
      "KC_TRNS",
      "KC_NO"
    ]
  ],
  "encoders": []
}